10
10
5
5
*________*
|*.....|.|
|.*....*_|
|........|
|........|
|........|
|........|
|.*......|
|*.......|
*________*